AFGHANISTAN=AF
ÅLAND_ISLANDS=AX
ALBANIA=AL
ALGERIA=DZ
AMERICAN_SAMOA=AS
ANDORRA=AD
ANGOLA=AO
ANGUILLA=AI
ANTARCTICA=AQ
ANTIGUA_AND_BARBUDA=AG
ARGENTINA=AR
ARMENIA=AM
ARUBA=AW
AUSTRALIA=AU
AUSTRIA=AT
AZERBAIJAN=AZ
BAHAMAS=BS
BAHRAIN=BH
BANGLADESH=BD
BARBADOS=BB
BELARUS=BY
BELGIUM=BE
BELIZE=BZ
BENIN=BJ
BERMUDA=BM
BHUTAN=BT
BOLIVIA,_PLURINATIONAL_STATE_OF=BO
BONAIRE,_SINT_EUSTATIUS_AND_SABA=BQ
BOSNIA_AND_HERZEGOVINA=BA
BOTSWANA=BW
BOUVET_ISLAND=BV
BRAZIL=BR
BRITISH_INDIAN_OCEAN_TERRITORY=IO
BRUNEI_DARUSSALAM=BN
BULGARIA=BG
BURKINA_FASO=BF
BURUNDI=BI
CAMBODIA=KH
CAMEROON=CM
CANADA=CA
CAPE_VERDE=CV
CAYMAN_ISLANDS=KY
CENTRAL_AFRICAN_REPUBLIC=CF
CHAD=TD
CHILE=CL
CHINA=CN
CHRISTMAS_ISLAND=CX
COCOS_(KEELING)_ISLANDS=CC
COLOMBIA=CO
COMOROS=KM
CONGO=CG
CONGO,_THE_DEMOCRATIC_REPUBLIC_OF_THE=CD
COOK_ISLANDS=CK
COSTA_RICA=CR
CÔTE_D'IVOIRE=CI
CROATIA=HR
CUBA=CU
CURAÇAO=CW
CYPRUS=CY
CZECH_REPUBLIC=CZ
DENMARK=DK
DJIBOUTI=DJ
DOMINICA=DM
DOMINICAN_REPUBLIC=DO
ECUADOR=EC
EGYPT=EG
EL_SALVADOR=SV
EQUATORIAL_GUINEA=GQ
ERITREA=ER
ESTONIA=EE
ETHIOPIA=ET
FALKLAND_ISLANDS_(MALVINAS)=FK
FAROE_ISLANDS=FO
FIJI=FJ
FINLAND=FI
FRANCE=FR
FRENCH_GUIANA=GF
FRENCH_POLYNESIA=PF
FRENCH_SOUTHERN_TERRITORIES=TF
GABON=GA
GAMBIA=GM
GEORGIA=GE
GERMANY=DE
GHANA=GH
GIBRALTAR=GI
GREECE=GR
GREENLAND=GL
GRENADA=GD
GUADELOUPE=GP
GUAM=GU
GUATEMALA=GT
GUERNSEY=GG
GUINEA=GN
GUINEA-BISSAU=GW
GUYANA=GY
HAITI=HT
HEARD_ISLAND_AND_MCDONALD_ISLANDS=HM
HOLY_SEE_(VATICAN_CITY_STATE)=VA
HONDURAS=HN
HONG_KONG=HK
HUNGARY=HU
ICELAND=IS
INDIA=IN
INDONESIA=ID
IRAN,_ISLAMIC_REPUBLIC_OF=IR
IRAQ=IQ
IRELAND=IE
ISLE_OF_MAN=IM
ISRAEL=IL
ITALY=IT
JAMAICA=JM
JAPAN=JP
JERSEY=JE
JORDAN=JO
KAZAKHSTAN=KZ
KENYA=KE
KIRIBATI=KI
KOREA,_DEMOCRATIC_PEOPLE'S_REPUBLIC_OF=KP
KOREA,_REPUBLIC_OF=KR
KUWAIT=KW
KYRGYZSTAN=KG
LAO_PEOPLE'S_DEMOCRATIC_REPUBLIC=LA
LATVIA=LV
LEBANON=LB
LESOTHO=LS
LIBERIA=LR
LIBYA=LY
LIECHTENSTEIN=LI
LITHUANIA=LT
LUXEMBOURG=LU
MACAO=MO
MACEDONIA,_THE_FORMER_YUGOSLAV_REPUBLIC_OF=MK
MADAGASCAR=MG
MALAWI=MW
MALAYSIA=MY
MALDIVES=MV
MALI=ML
MALTA=MT
MARSHALL_ISLANDS=MH
MARTINIQUE=MQ
MAURITANIA=MR
MAURITIUS=MU
MAYOTTE=YT
MEXICO=MX
MICRONESIA,_FEDERATED_STATES_OF=FM
MOLDOVA,_REPUBLIC_OF=MD
MONACO=MC
MONGOLIA=MN
MONTENEGRO=ME
MONTSERRAT=MS
MOROCCO=MA
MOZAMBIQUE=MZ
MYANMAR=MM
NAMIBIA=NA
NAURU=NR
NEPAL=NP
NETHERLANDS=NL
NEW_CALEDONIA=NC
NEW_ZEALAND=NZ
NICARAGUA=NI
NIGER=NE
NIGERIA=NG
NIUE=NU
NORFOLK_ISLAND=NF
NORTHERN_MARIANA_ISLANDS=MP
NORWAY=NO
OMAN=OM
PAKISTAN=PK
PALAU=PW
PALESTINIAN_TERRITORY,_OCCUPIED=PS
PANAMA=PA
PAPUA_NEW_GUINEA=PG
PARAGUAY=PY
PERU=PE
PHILIPPINES=PH
PITCAIRN=PN
POLAND=PL
PORTUGAL=PT
PUERTO_RICO=PR
QATAR=QA
RÉUNION=RE
ROMANIA=RO
RUSSIAN_FEDERATION=RU
RWANDA=RW
SAINT_BARTHÉLEMY=BL
SAINT_HELENA,_ASCENSION_AND_TRISTAN_DA_CUNHA=SH
SAINT_KITTS_AND_NEVIS=KN
SAINT_LUCIA=LC
SAINT_MARTIN_(FRENCH_PART)=MF
SAINT_PIERRE_AND_MIQUELON=PM
SAINT_VINCENT_AND_THE_GRENADINES=VC
SAMOA=WS
SAN_MARINO=SM
SAO_TOME_AND_PRINCIPE=ST
SAUDI_ARABIA=SA
SENEGAL=SN
SERBIA=RS
SEYCHELLES=SC
SIERRA_LEONE=SL
SINGAPORE=SG
SINT_MAARTEN_(DUTCH_PART)=SX
SLOVAKIA=SK
SLOVENIA=SI
SOLOMON_ISLANDS=SB
SOMALIA=SO
SOUTH_AFRICA=ZA
SOUTH_GEORGIA_AND_THE_SOUTH_SANDWICH_ISLANDS=GS
SOUTH_SUDAN=SS
SPAIN=ES
SRI_LANKA=LK
SUDAN=SD
SURINAME=SR
SVALBARD_AND_JAN_MAYEN=SJ
SWAZILAND=SZ
SWEDEN=SE
SWITZERLAND=CH
SYRIAN_ARAB_REPUBLIC=SY
TAIWAN,_PROVINCE_OF_CHINA=TW
TAJIKISTAN=TJ
TANZANIA,_UNITED_REPUBLIC_OF=TZ
THAILAND=TH
TIMOR-LESTE=TL
TOGO=TG
TOKELAU=TK
TONGA=TO
TRINIDAD_AND_TOBAGO=TT
TUNISIA=TN
TURKEY=TR
TURKMENISTAN=TM
TURKS_AND_CAICOS_ISLANDS=TC
TUVALU=TV
UGANDA=UG
UKRAINE=UA
UNITED_ARAB_EMIRATES=AE
UNITED_KINGDOM=GB
UNITED_STATES=US
UNITED_STATES_MINOR_OUTLYING_ISLANDS=UM
URUGUAY=UY
UZBEKISTAN=UZ
VANUATU=VU
VENEZUELA,_BOLIVARIAN_REPUBLIC_OF=VE
VIET_NAM=VN
VIRGIN_ISLANDS,_BRITISH=VG
VIRGIN_ISLANDS,_U.S.=VI
WALLIS_AND_FUTUNA=WF
WESTERN_SAHARA=EH
YEMEN=YE
ZAMBIA=ZM
ZIMBABWE=ZW